#@#########'++++'++++##+++++'++++++######################################+'####+''+###++#########++++++'+'++####################################################################'''###++++#############@
#''###++###++++'+'+'+++++++'''''';+++####+++#+++#########+##++#++'''#''''';;;+#'''++'+++'''+'''++''''''''''''''''''++++++'+''#####+''''''+++'++###########+++'+'''''''''+''''''#'''+#+##++++############
#'+'##+++##';##+#+##+#+''++++##'++'+++';#';'''''''''''''+'''''''''''+'''';;:;;+';'''''''''''''''''''''''''';'''''''''''''''';#''''''''''''++''''';''''###''''''''''''''''''''''''''++++##+'+++##########
###;:#++'+#':#+++'+#+++++++##+';''';'';'#;;;'''';'''';;;;+;'''''''+''''';;;;;;;;''''''''''''''''''';'''''';''''+'+''';';'''';;'''''''''''''''';;;';;''#+;;''';';;';;'';;''''''''''''+++++#'++++'++######
###+;'#+'+#''#+++#+#+++'+##+''''''';'';;#;;''';''';''''''+;''''''''''''';;;;;:;';;''''';;'''';'';';''''''''''''++';';';;''';;;';''''';''''''''';;';;;;':;;'';;;';;;''''''''''''''''''''+++##++'';''+++##
####+:;'+#''++++++#+++''+''':;''''';;;;;+:;;'''';;'';';';;;''''+'''''''';;;;;;;;''';';;;;';;'';';;'''';'''''''';:'';';';'';;;;;;';;''''';'''';;';;'''';;'';';';';;;;''''''''''''''''''''++++#'''';;'''++
###+#+;;##':+'+'#;+'''';:,;'+'''''';;:';;:;;'''';;;'';;';;';'''+''''''''';;;;;;;;;''';;;';;;;;';';;;';'''''''''::::+';'''';;;;;;';;;;';''';'';;;;';;;;;;';';;;'';;;;''''''''''''';'''''''+++++''';;;:;'+
##+'++;:+'''''+#+:++'+':;''''''''''';'';;;;;';;''';';';;';''''''''''''''';;;;;;;;;';;';;;;;;;;;;;;';;;'''''''''';::+'';;;';;;;;;;;;;;;'';;;;;;;;;;;;;;;';;;;;;;';;;;';''';''''''';''''''''+++#''+';;::;;
#+'''+#+;::'''#++;#';+';';'';'';''''''';:';'''''';'';';;'''';''''';'''''';;;;;;;;';;;;;;';;;;;;;;;';;;;'';;';'';':;+''';';;;;;;;;;:;;;;;;;;;;;;;;;;';;;;';';;;'';;;';;;;;''''''''''''''''''+++##++';:::;
#++'++#'':'###+;;;+'+;:;;;';;;''';'''';;;;'''';;;;';;';'''';;''''''';'';'';';;;;;;;;;;;;;;;;;;;;';;;;;';;;;;;'';+:;+';;;;;;;;;;;;;;;;;;;;;;;;;;';;;;';';;;;;;;;;'';;'';;';;'';''';''';;';''''++++#'';:+#
#####+'':',,'+;;,+;';''';;;';';';;''';;;;;'''';;;';;;';;';';';'''''';';'';;;;;;;;;;;;;;;;;;;;;;;;;;;;;;;;;;'''''+:;''';;;;';;;;;;;;;;;;;;';;;;;;;;;;;;;;';;:;;;;';;;'';'';';;;;';;'';;;;;;'''''++#'''+##
###++'':+'::';:';'';:;;;;;'';;;;;;'';';;;;'''''';;;;;;;;;';;';';';;;;;;;:;;;;;::;;;;;;;;;;;;;;;;;;;:;;;;;;;;;';';;';;;;;;;;;;;;;;;;;;;;;;;;;;;;;;;;;;;;;;;;;;;'';;;''';';'';;;'''';';;;;;;;;''''+++'+###
#''+:,+''+'+;:;:':,;;;';;';';';;;;'''';;;;''';;;;;;;;;;;;';;;;'';;;;';;;;;;;;;;;;;;;;;;;;;;;;;:;;:;;;;:;;;;'';;''+'';;;;;';;;;;;;;;;;;;;;;;;;;;;;;;;;;;;;;;::;;;:;;;;;'';;;';;;;';;;;;;;;;;;''''''+++#+#
#''+##+;'+#'':';;:;;;';';;';';;;;;;'';;;;;'';;';;;;;;;;;;;;;''';;';;;;;;;;;;;';;;;;;:;;::;;:;:;;;;:::;;::;;;;;;;;'';;;;;;;;';;;;;;;;;;;;;;;;;;;;;;;;;;:;;';;;;;;:;;';;;;;'';;';;;;;;;;;;;;;;;';'''++++++
+';+#';'++#';;:;;;;''''';';;;;;;;;;;;';'';;';;';;;;;;;';;;;'''''';;;;';;;:;;;;;;;;;;:::;;:::::;::;::;;:;;;;;;;;;;;;;;;;;;;;;;;;;;;;;;;;;;;;;;;;::;:;;;;;;';;;;;;;;;'';;;;;;;;;;;;;;;;;;;;;;;;;;';'++++++
#''+'+;+#''':;;;;;;;''''';;;;;;;;';;;;;;;';;;;;;;;;;;;;;;;;'''';;;;;;;;;;;;;;;;;';;;;:;::::::;::;;;;:;:;:;;';';'';;;;;;;;;;;;;;;;;;;;;;;;;;:::;;:;:;;;;;;;;;;;;;;';;';;;;';';;;;;;;;;;;;:;;:;;;;;;'''+++
++'+'+'#'';,;;;;;;;;;;';;;;'';;;';;;;;;;;;;;;;;;;;;;;;;;;;;'';;';;;;;;:;;;;;;;;;;;;:;:::;:::::::::::::;;;;::;;';;'';;;'';;;';;;;;;;;;;;;;;;;;;;;;;:;;;;;;;';;;;;;;;;;;;;;;';;;;:;;;'';;:;;;;;:;;;'''''''
++'+'+#++;'+';;;;;';;;;;';;;;;;;';;;;;;;;;;;;;;;;;;;;;;;:;;;';;;;;;;;:;;;;;;;;;:;;;::::::::,,:::::::::::;;'''+'';;;';'';''''';;;;;;;;;;;;;;:;;::;;;;;;;;;;;;;;;;;;;;;;;;;;';';;;;;';;;::;;;;;:;;;;''''''
+'''+++,;++;';;;;''';;;;;;;;;;;'';':;:;:;::;;;;;;;;;;;:;;;';'';;;;;;::;;;::;;;;;::;:::::,::,::::::::::;:;;';+'';;;;''';;;;;;;;;;;;;;;;:;;::::::::;::;;;;;';;;;;;;;;;;;;;;;'';;;;;;;;;;;;;:;;:;;;;';;''''
#'''++'++;';';';'''';;;;;;;;;;';';;;::;;;::;;;;;:;;;:::;:;;;;;;;;;;;:::::::;::::;;:::::::::,,:::::::::::;;;;+''';:+++'';;;''''';;;;;;;;;:;;;::;:;;;;;:;;;;;;;;;;;';;;;;;;';'';;;;;;;;;;;;;;;:;;;;;;;''''
#++#+++'+';:''';';;'';';;;;:;;;;;;;;;::;;;;;;;;:;;;::;;;;;;;;;;;;;;;::::::::;::;;;::::::,:,:::;;;::::;;;';''+++'+++##+''''''''';;;;;;;;;;;:;;::::;:;;;;;;;;;;;;;;;';;;;;;;';;;;;;;;;;;::;;;;;;;;;';'''''
#+''+++:++''''''';;;;;;;';;;;;;;;;;;;;:;;;;;:;:::;:::::;;;;:;;:;:::::;::;::::::::;;;::::::::::;;;;;::;;;;;;;+:'';;+:#'+';;;;;';;;;;;;;;;;;;::::::::;;;;''''+';:;'';;;;;;';';;;;;;;';;;;:;;';;;;;;;;;''''
#+'''++#+';'+''''';';;;'';;;;;:;;;;:;;:;::::::::;;;;;:;;::;;:;:;:::::::::::::::::::,:::::::::::;;;;;;;''''''::+;::+:#;+'';''';;;;:;:;;;;;:;;;:;:;;;;;';;'+';;';;;;';'';;;:;';;;:;;;;;;;;;;;;;:;;;;;';;;'
#####+'+':'''''''''';;;';';;;;;;;;;::;;::::;::;:::::::;::::;::;;::::,:,:::::::;;;:::::::;:::::::;:;:;;;;:::;;+';::#+#;';;';;;;;;;;::::;;;::;:;:::;;:;;;:;;;;';';;;'';;;;;;;';;;;;;;;;;;;;;;;;;;;;;;;'';'
#'++++'+'''';'''';;';;';;;;;';;;;:;;:;::;::;:;::;::::;:::::;;;:::::::::::;::;:::;;::::;;;;:::;;;;::;;;;;;'';';+;;:::;;+';;;;';;:;;:;:::;;;:;;::::;:;'';;;;;;+;';;;;;;;;;;;;;';;;;;;;;';;;;;;;;;;;;';;';;
#+''++;''';'''''''';'';';;;;;;;':::::;;;:;::::;:;;;;;;;::::;::;:::::::,::::::::::::;;:;;;;::;;;;;;;:;;;;:;';+''::::;;;'+;';;;;::;:;:;:;:::;:;;;::::;:';;;;;;;;;':;;;;;;;;;;';;;;;;;;;;;;;;;;;';;;;;';;;;
#+;;++:''''''''''';;;';';';;;:;;::;;:;;;;;;;::::;:;:;;;;,::;:;::::::::::::::;;:;:;:;;::;::::::;;;;;:;;;;;:'++';:,::::;;''+';;;;;;;:::::::;:;;;;::::'';;;;;;;::;;;;;;;;;;;;;;;;;;;;;;;;;;;;;;;;;;';;;;;';
#';;+';'''''''''';:;;;;';';';;;;';;;;;;;;;;::;;;;;;;;;;;::::;;:;::::::::::::::::;:::;;;::::::::;;;::;;;;'';+'';:::::::;'+';;;:;;;:;;;::::;::;;;;;;'++';''';;''+;';;;;;;;;;;''';';;;;;;';;;';;;;;;;;';';'
++';#+''''''''';';;';;';;';;:;;:;'';;;;;;::;::;:::;::::;::::;:;::::,:::::::::::::::;;:;:;:::;::::;;;;;::;;;+'';;;::::;;''';;';;:::;;;;:;:::;;;::;;;;''';;;;;'';+;;;';;:;;;;;;;;';;';;';;;;;;';;;;;;;';;;
+'''#';'''''''''';;;;;;;';;:;;;;;';;;;;;;;:;;;;:::;:;::::;;:;;:::::,:::::::::::::;;;:;::;:::::::;::;::::;';+'';:::;:::''';;;;;;:::;;:;:::::;;:;;;;;';;:;;;';;;;':;:;;;;;;;;;';';;;;';'';;;;;;;;'';;;;;';
+''#':;'';;;''''';;;;:;;;';::;;;;;;;;;;;:::;;;;;;;;;:;::;;::;:::::,:::::::::::;::::;;;::;:::::::::::::;;;;;;+'':::;;'''+';;;;::;;:;:::;:::;;;;;;;;:+;;';;;;;';;;;:;;;;;;;;;';;;;;;;;;';;;;;;';;;;;;;;';;
+;+#';'''';;'''';';;;:;;;;;;;:;;:;:;;;;;::::;;:;:;;;:;::::;;;;;;::::::::,::::;;:;:;:;;:;:::;:;:;;:::;;;:;;:'++';#;+;;'++';;;:;;;:::;:;;:;:;:;;;;;;;;;;;;;;;';;+;;;;;;;;;;;;;;;:;;;;;;;;;;;;;;;;;;;;';;''
#'+';'''';''''';;;;;;;:;;;;;:;;;;;;;;;:;;:::;;:;;:;;;;::::;;;;;::::::::,::::::;;;;;;::;;:::::;;::::;;;;;;;:;+'''':';'''+;;;:;;;:::::::;::::;;;;;;;;;';;';;';';;;;;;;;;;;;;;;;;;;;;;;;;;;;;:;;;;;;;;;;;''
+'++'''+;';''';;;;;;;;;;;;;;;;;;;:;;;:;;;;:::::;;:;;;::;;::::::::::::::;:::;:::;;;;;;:;::::::;;:;:::::::';;;+'';#;';;''+;;;::;;:;:::::;::;;;;;;;;;;':;;;'';;'':;;:;;;;;;;;;;;;;:;;;;;;;;;;;;;;;;;;;'';''
#+';'''+''''';''';;::;;;;;;;;:;;:;;;;:;;;:;;;;;;;:;;;::;;;:::::,:::;:;;::::::;:;;;;:;;;:::;::;;;::;;''''''''+';;;;;;;;'+'';';;;::;::::;:;:;;;:;;;:;:;:;';;'';;;;::;;;;;;;;;:;;;;;;;;:;;;;;;;';;;''''''''
++'''+'''''';;'';;;;;;';';;;;;;::;;;;;;;;:;;:;;;;;:;;;;;;;:;::::::;;:::::::::::;;::;:::;::::::;;;;:;;:;;;;'+';;;;;;;';'+;';';;;;;:::;;;;:;;;;;::;;:::::::;;;;;;';;;;;;;;;;;;;;;;;;;;;;;;;;''''';''''''''
#'++'+''''''';;''':;'';;;;;;;;:;;;;:;;;:;;;;;;;;:;;;;;;:;:;:;::::::::::;:;:::::;;:;:;:;;::;:;:;;';;;;';;'+'+++;;;;'''''+;:;:;:;;::::::;;:;::;:;:;;:::;;::;;;;;;;;;;;;;;;;;;;:;;;;;;;;;;;;;;;;;';''''+'''
##+++'''''''';'';';;;;;';;;:;:;;;:;;;;;:;;;;;;;;;;;';;:::;;:;';:::::::::::,::::;::::::;;::;;:;;;;;;;;;;'+++';+;;;';';''+';;';;;::,::;;:;::;;;::;;::::;:;;;;;;;';;;;:;;;;':;;;;;;;;;;;;;;;;;;';;'''+++'';
##+++''+''''''';''';;''':;;;;;:;;::;;;;;;;;;;;;;;;;;;;;;;';';';:::;:::;:;::;:::::;::;;;;;;;;:;;';;;;;;'';:;:;;';;;;;;''++;'';;:;:::::;:;:;;;:;;:;:;;;;;;;;:;;;;;;;;:;;;;;;;;;;;;;;;;;;;;';';'';''''+'';;
##++++'''''''''''';;;;;;;;;;;;:;:::;;;;;;;;;;::;;:;;;;;;;'';''':;;::::;;:;;:::::::;;:;;'';;;';;;;;;;;;+':;::;;''::::;''''+;;;;;;;::;:;;:;;;;:;';:;;;;:;;;;;;'''';;;;;;;;;;;;::;;;;;;;;;;;;:;;;;''+'+'';;
##''+;''''';;''';';';;';;;:;;::;:::;;;;;::;;:;;;;;;;;;;'';''';;;'';;::;;;:;:::;::::::;;;;;;;;;;;;;;;;+;:::;::;;;;;;;;;'''+'';;;;;:::::;;;;;;;;;:;;:;:;;;;;;;;;;;;;;;;;;;;;;;:;;;';;;;;;;;;;;;;;;''+''';;
##''''''';';'''''';;;;;;;;;;':::;;;;:;;;:;:;:;;::;;'';;;;;;;;;';;;';:::::::;:::;;;;;;;;;'''''''''''++';;;;:;;''''''+#;;;'++'';':;;;::::;:;;;;:;;:;;;:;;;;;;:;;;;;;;';;;;:;;;;;;;;;;;;;;;;;;;;;'''''';;''
##+';'''''';''''';;:;;;:;;;;::::;;;;;;:;::;::;;;;'';;';;';;';''';;;;;';::;:;;:;;;::::;;;;;';;;';+++';+';''+'+''+++;:;';;''+'';;;;;::;:;;;;;;;;;;;;;;:;;;;;;;;;;;;;;;;;;;;;;;;;;;;;;;;;;:;';;;;''''''';''
+#+'';''''';''''';;;;;;:::;;;;;;;;;;;:;:;;;:;::;;;;;;;;;'''';';;:;;;;;:::;;''';;;;;''';;'';'';:+'+';;;;;''';'''';;+#;';;;;'+'''';;:;;:;;;;:;;;;;;;;;;;;;';;;;;;;;;;;;;;;;;;;'';;;;:;;;;;;;;;;;''''''''';
+#+''''''''';'''';;;:;;::;;;;;;;:;;;;;;;;:;;;::::;;'';;;;;;;;;;'';;;::::;;;;;;;::;:;''+++;';;'+''+;;;';';';;;';;;;;;:;;;;''+;;;;;;:;;;;;';;;;;:;;;;;;;;;;;;;;;;;;;;';;;:;;;;;;;;;;;;;;;;;;;;;;;'''''''''
+#++'';;;'';''';'';;;;;:;:;;;;;';;;;;;;;::;::;;;;;;;;;;;;:;':;:;;;';;::;;;:'';''''';:+'''+++'+;';';:;;+'';;;;;;:;;::;;'+;'+';';;;;;:;;;;;;;;'';;;:;;;:;;;;;;;;;;;;;;;:;;;;;;;;;;';;;:;;;;;;;'';''';'''''
+#+''''';'''''''';';';;::;;;;;;;;;;;;:;;:;:::;::::;;;;;;;::;'';;;;;::;:;;''''''';;;:'+';;'''';;;;';:;:'+'';;;;:;:;;;;;'+''':';;;::;;;;;;;;;;;;;;'';;;;;+;;:;;;;;'';;;;;;;;;;''';;;;;;;;;;;;'';;'';;'';''
##+''''''';;'';';''';;;:::;:;;;;;;;;;;:;;:::;;::;::;:;;:;;;:::::;;:::::;;;;;;'''+'+;+';::;''';::;;;::;'+'';;;;;:::::':;''+;';;:;:;;;:;;;;;;;;;;:';;;;;;';;;;;;;';'';;;:;;;;;;;;;;::::;;;;;;;;';;';;'''''
##++'''''''';;';;;;;;;;:;;;;;:'::;;;;:;:;;:;::;:::::;:;:;;::;::;;;;:::::;;;;':'''''+''::,::;;;::;;;:::''';;;;';;:;::#'#'+';';;;;;:;;;;;;:';;;';;;;;;;;;;;;;;;;;;';;;;;;;:;';;;;;;:::;;;;;;;;;;;;;;;;;'''
#;';;''''';'';;;;;;;;:;;:;;;;;;;:;;;;;;::;::::::;:;;:;:::::::;::::::::::;:;;;+''';''';::::;;:::;;;:::;'++';;;;;::;::;;+++;';;;;::;;;:;;;;;;;;;:;;;;;:;;;';;;;;;;';;;;;;::;;;;;;::;:;;;;;;;;;;;;;;;;;''''
#+';''''''';'';;;;;;;;:;;;;;;;;:;;:;;:::;:;::;;::::::::;::;;::;:::::::;;;;;';+'';;;';;::;;;';;:;'+;;:;'++';;;;;;:;:;;;;'++';;;:;;;;;:;;;;:;;:;;;;;;;;;;;;;;;'';';;;;;;;:;;;;::;;::;;;;:;;;;;;;;;;;;;;'';
#++''''';;;'';;;;;;;;;;;;;;;;;;;;;;;;;:::;:::::::;:::;;;:;;;:::;:::::::::;;;;+';;;;:;;;;';';;''#,+,;;''++''';;;:;;;:;;;''+;;;';;;;;;;;;;;;;;';;;;;;;;;;;;;;;;;;;;;;;;:;;;;:;;;;;:;;;;;;;;;;;;;;:;;;;'';'
#+'''''';';';;;;;;;;;:;:;;;;;;:;:;;;;:;;;;;::::;;;:::;:;;::;:::::::::::;;'''';+';:;;:'';';+;;';++::;;#++;+''';;;;;:;;;'''+;;;;:;;;;;;;;;;;;;;;;;;;;';;;;;;;;;;;;;;;;;;;;;;;;;;;;;;;;;;;;;;;;;;;;;;;;;;;;
+'++'''';;';;;;;;;;;;;;;;;;;;;:;;;::;:;:;;;:::::;':::::;:::;::::;:::::;;;;;;;';+''';;;''#+++++''++;,'#::;;+''';;:;;;';;''+;';;;''';;;;;;;:;;;;;;:;;;;;;;;;;;;;;;;;;;;:;;;;:;';;:;;;;';;;;;;;;;;;;;';;';;
#''''''';';';;;;;;;;;;'';;;;;;;::;:;;:::;:;;:::;:;:;;:;;;:;:::::::::;:;;;;;;;;';;+;;;'+;;;::'''+++';##;++;''';;';';;'+'+'+'''''';';;;:;;;';;:;;::;;;;;;;;;;;;;;:;;;;;;;';::;;;;;;';;;;;;;;:;';;;;;;;;'';
#''''''';;;;;;;;;;;;;;;;;;;;;::::;;:::;:;:;;::::;::::;;;::;'::;:::::::::::;;;;'';'';;+;'+;;:''';'+##'';++;+''';;;;';'++':;':;;;;;'::;:;;;;;;::;:;;;;;;;;;;;;:;;:;;;;;::;;;;:;'';;:;;;;;;;;;;;'';;;;';';;
+++'''';'';;;;;;;;;;';;;;;;;;;;;;;;:::;;;:::::;:;::::::;;::::::;:;:;::::;;;:;;;;''++'+:'';;;';;;;''#+'++++++';';'''++;;'';;:;;;;;;;;;;;;;;;;;:;;;;;;'';;;;:;;;;;::;;;;;;;;;;;;;;;;;;;;;;;;'';'';;;';;;;'
#++'+'';;':;'';;;;'';;;;;';;;;;;:;';;;;;;;::::::;;;;':'';;;:::::;;::;:;;;;;'''''''+:'+;:+;;+';;'''++++''''''+'''''++;++''''';;:;::;::;;:;;;;::;;:;;;;;;:;:;;;;;;;;;;;;;;:;;;;;;;;;;;;;;;;;;'''+;';;;;;';
+++++''';;';;;;';;;';;;;;;;;:;;;::;;;;;;;;;;;:;,:;::;;':::::::::::::::;;;;;;;;;''';+;;+':;+';;''''+'+:+;;;''''+++++;;;;;;;;;;;;:;;;:::;:;;:::;::;;;;;;;;:;;;;;;;;:;:;;;:;;;;:;;;;;;';:;;;;;''''';';;;;;;
+++++'';;'';'';;';';;;:;;;::;:;:;::;;;;;;;:;;::;:;::;;;;::::;;;;;::::::;';;;;;';':#+;;'++'''';;+'+'++#';;;;;+++++++';;;'';';;:;:::;;:;:::;;::;;;:;;;;;;;;:;;;:;;;:;;;:;;;;:;;;;;;;;;;;;;;;;''';;;;;;';;'
#+'+'';';;''';;';';;;;;;;;::;;;;:;:;;:::::;:::;::::;:::,::::;:;;:::::;;;;;;;;'''';+;;;;;+';;;'#;:'''+';;::;;;;'''++''''''';;';;;;::::::::;::;:;;;;:;;::;;:;;;;;;;:;;;;;;;;;;;;;;;';;;;:;';;''';';;;;;;''
###+'';;''''';;';;':;;:;;;;::;::::;;;;;;;;:::;;;;;;;:;:::::::::;:;;;::;;;;;;;'';;;+';;;;;;;;;;''++''';;;:;:;;;;;'''';;;;;;:::;;:;::;;:::::;::::::;:;:;::;;;:;;;;;;;;';;;:;:;;;;;:;;;';;;;;';;'';;;;;';;;
##'''';;;''''';''';;;;;;;;:;::::::;;;;;;;;;;;;;;:'':::::,::::;:;;:;;;;;;;;;;;;:''''';;;;;';;'';+#'';';;::::;::;;'++''''''::;;::::::;;;::::;::::;;;';:;;;::;;;;;;;;;;';;;;;;;:;;;;;;;;;;';;;';;;';;';;'';
##+''';;''';'';;;;;';;:;:;;::;::::::;;;;;:::+,':;,:::;::::,:::;;;::;;:;;;;:';'';;::+;;;;'';;;'#:+';;+'+;;;:::::;'#;';;;;;;;;;::::::;;;;;:::;::::;;;;:;;:;:;;:;;;;;;;;;;;;;;;;;;;;;;;;;;;;;;';'''';''''';
##''''''''';';;;;;;;;;:;::;;;;:;::::;;;;:;;;::::;,:::;:+:,;::::::::;;;;;;;';;;;:;;++';;;+;;;;;'++'#',:;;;,:''';''''';;:;;::;::;;::;;';;;::::;;;;:::;;;;;;:;;:;::;:;;;;;;;;;;;;;;;;;;;;;;;;;;;;''''''''''
#+++''';'';';;;;;;;;;;::::;;;::;;;::;;;;;;::::+;;+::;::+:;;:::::::;;'';;;;':;+''+'''';'';;;;'''++';,#;:::::';;';+##''';;:;:;;::;::::;;:;:::::::::;:;;:;;;;:;:;;;;:;:;;:;;;;;;;;:;;;;;;;;;;;;;';'';'';;''
#''''';;';;:;;;;;;;;;;;::;;::::;;::::;;:::;:;+':;;;;;:';':'::::;;;;;;;;;;;;';:+';'';;';';'';'+'+'#,'+:::;::+'#;++;'''';;::;::;;;;;;::;;:::::::;::;:;::;;;;::;:;;::;;:;;;;:;;;;;;;;;;:;;;;;;;;;;';;''''''
#'''';;';;;::;;;;;;;;::;::;::;;;;:;:;;:;;::;:,:::::;;;:::::::::;;;;;;;;;;;'+:'''';;;;;;+';'+';:++:;++;++',:;;+;'++;;;;;:;;;:;;;::::';:;;:::::::::;::++;:;;:::;;;;:;:;;;;;;;;;:;;;;;;;;;;;;;;;;;;;';'''';
#''';;'+';:;;;;;;;;;;;:::;;;;;;;;;:::;;;;;;:;:;;:::::;;;:;;::::;;;;;'';::;;;;;';''':;;';+'::;;+;+##';:+:',::::;''''';';:;;;::::;:;:;::::::::::;;;;::::;;:;;;;;;:;;;;:;;;:;;;;;;;;;;;;:;;;;;;';'';';;;'';
####+'';;;;;;;;';;;;;;:::;;;;;;;;;::;;;;:;;:;:::+::;::;:::;:::::;;;;+'''':+';+';;;;:;;';:::;';';'++';::,,::;;;;+;';:;;;';:;;:;:;:;;::::::::::::;:;:;::;;+';+;;;;:;;;;;;;';'';:;;;;;';;;;;;;;'';;;;;;;'';
##';;;;;;;;';;;';;;;;;::;;;;;;;;;;;;;:;;;::;;::',::'::'::;;:;::';';'';;'+;';'+';;;:::;'+;:'';;'';;+'';;:::::;;''+';;;;;;;;;;;:::;:+:::::::;:::::::::;:;;;';;;;;;;;;;;;;;;;;;';;:;;;;;;;;''';';;;;;;;;;;;
#';;;;;;;:;;;;;;;';;;;::;;;;;;;;;;;::::;;':;::::+::;;::::;;:::;;;;;+''''++;;:+';;;;;;'++;;';:;;''+;#'';;;;;;;''+'''';''';';;;;:;:;;:::;::::::::::::::::;;;;';;;;;;;;;;;;:;;;;;;;;;:;';;;;;';;;;;;;;;;;;;
+';;;:;:;;;;;;;;;;;;;:::;;;;::;;;;::;:;;;;;;;::,,,:::::':::;::;';';'''';+;;';''';;;;''++;:;:;:;'';'+++'';'';''+;';''';;;'';;;;;:;;::::;::::::::::;::::::;;;;;;;;;;;;;;';:;;;;;;;;;;;;;;';''''';;;;;;;;;;
#';;:;;;;';;';;;;:;;;;:;;;;;;;;;;;;;;:;:;;:;;:;,,;:::::::::::;;:;;:+++++;;:;';;''''''+;;+;:++::;;;;:;++++++++++';;;;:++;;';;:;;';;:::;;;::,::::::::;::::;';:;;;;;;;;;;;;;;;;;;;;';;'';;''';'';;;;;;;;;;;
#';;;:;::;;;;;;;;;;;;:;;;;;;;;;;;;;;;;::::::;;:;:::;;::::::;;:';;;;:;+++++';;';;'++'+';':::;;;;'''+:++'+;;;;++'';++++''+';;;;'';;;::;;:;:::::;::;;:;;:;:;;;;;:;;;:;;;;;;;;;;;;;;;''''';;;;'''';;;;;;;;;;
#'';;::;;;;;';;;;;;;;:;;;;;;;;;;;;;;;;::;::;;:;;;::::::::::::;;;;';;:+;'''+';:;;;::;;;'+;'+;;;;;;:;++'++++++;''#:+'';;;'++;''';;;:;:;;;:;:+;;:::';:;:;;:';':::;';;:;;:;;;;;;';;;;;;;;''';';''''';;''';;;
+#';;::;;'';;;'';';;;;;;:;;:;;;;;;:;:;::;:::;:::;;::::,::;:::;:;;;;;;+;+:+'';;;';'++;'';;;;;::;';+++''';'''+;+,:#';;;;;;'''++::;;:::;;;:::::::::;':;,;;;':';:;;'::';':;;;'+;;;;;;;;;''''';''';'';;;;'';;
+'';;;;;;'';';;';;;;;;;;:;;;;:;;;;:;;::;:;;::::;::;:;:::;::;:;:;;;;;;';''#+;;;''''''''''';;;;'':++'';;;;;;;';';'+;;;;:;;''+;;';;;;::;;;;:,:::::;:;::,:,:::;::;;;;;;;:::;;;';:;;;;;;';;;;;'''''';;;'''';;
#'';;;;'';;';'';;;;;;;;;;;;;;;;;;;;;;;:::::::::;:;;::;;::;:;;;;;::;;;''';'';;::;;;';;;;;;;;;;;';+'';':::;;:;+.;#;;;:::;;;'+;''';:;;;;;:::::::::;;;:;:::;:;;;;;;;;:;;;;;;;;;:;;;';;';;;;';;'''''';'''''''
++'';;;;+;;';;;;;;;;;;;;;;;;:;;;;;;;;:::,,::;::;;;;;;:;:;;;;:;;;:;;;;;+'++;;;;;';'''''';';;;;';'+'';+::::::'+:';;:::,:::;'';;;;;;;;:;;:::::::::::;:;;::;;;;;;;;;;;;';;;:;;;;;;;;;'';;;;;;''''';''';'''''
##'';;;;''';;';;;;;;;;;;;:;;;;;;;;;;;:::::::;:;;:;:;;::::;;;;;;:;;;;;;:;;;;;;';'';'';';;;;;;;'';'+'++,,:::::':::::::::::;';:'''';;;::;;:::::::::;;::+';;:;;;;:;;;;::;;;;;';;;;;;;';''';;;''';'''''''''''
##+'';''';';''''';;;;;;;;;;;;;;;;;;;;:::::::;;:::;:;;;:::;;;;;;;::::;;:;;'++''';;::;;;;;;;;;;;+++'++;::::::::::,,:::,,::;'#:;;'';;::::::::::::;;;;;:':;::;;+;;;;;;;;;;;:;;;;;;:;;;';;';';;'';;;';'''''''
##+'''';'';'';''';;;;:;;;;;;;;;;;;;;::::::::::::::;;;:::;;;;;;;;;:::;;''';+';;;'''''''''''''';##'+'';;:::::':;::::::,,::;+';+''';;;;:;;:::;::;;:;;:;:'::;;:':;;;;;;;;;;;;;;;;;;;;';'';;';;;';;;;;;''''''
##+;;''''''''';;;;;;;;;;;;;;;;;;:;;:::::::::::;;:::;:;::;;;;'';;:;;''':';;';;;;;;''++''';';+'':+++;';;:;:::'::::::::::::;'+'''';';;;::;;:;:;;:;;;;;:++;;:;';';;;;;;;;;;;;;;;'';;;;;;''''';''';;;;;''''''
##'';;'';'+;;'';';';;;;;;;;;;;;;;;;:::::::::::::::;:::;;:;;:';;:;:;;;';;;;;+';;;:';;;';'+'+';'++'''++';;;:;+;:::::::::::;''';;'';;:;;::;:;;;;;;;;;;;;;;;;;;;;'';:;;:;;;;;;'';';';';;;;';''';;';;';;;''++
+##+;'''''+;';';;;;;;;;;;;;;;;;::;;;:::;;;;;;:::::;;:;:;;;;;;;;:;;;;'';';;;++'''+;++++++'''++++#++:;;;+;;'''+;:;;;::::::;';+'';;;;;;:;:::;;;:;;;;;;;;;;;:;::;;:;;;;:;;;;;;;;;;';;;;;;;;;';;;';;';;';''++
+#';''''+'';'';;;'';;;;;;;;;;;;;;;;:;::::::::::;::;;:;:;;';:;;;;';';+;';';;;+'';:'';;'+';:;;';;+:+::;;;+'+'+'+';;;;::::;;;'#:'+;;:;::;;:;;;;;;;;;;;;;;;;;;;;;;;;;;;;;;;;;;;;;;;';;;;;;;;'''''';'';;'''''
+##'''''''+';;;;';;;;;;;;;;;;;:::;::::::;;;;:::::::::::::;;''''+';'::;;';;;+'+'';+';;;;::,::::,#:#:,::;+;'';;+;;;;;;;::;';+'++';';;;;:;;:;;;;;:;;;;;;;;;;;;;;;;;;;'':;;;;;;';;;;'';;;;;;;;'''';;''''''''
##+;''''''';';;;'';;;;;;;;;;:;::;:::;:::;;:;:;;;:;;;;::;'''';:;';;''';;;++'''''''+;;::::,,,,,,,###.,,::';'+;++;;;;;;;;;;++':'+;'':;::;:;;;';;;;;;;;;;;:;;;;;;::;;;;;;;;;;;;;;:;';;;;';';';'';;;;''''''''
#';;;;;;;;'''+;'';::;;;;;;::;;:;:;;;;:;;:;;:;;';;;;;:;;;';:;'';;';;;;';;+;;;';;';;'++',++#;.++:..++,,.+;+':''+;;';;;;'''+:;:;;';:;:::::;;;;;;;;;;';;;;::;;;;;;;::;;;;;;;;;;;;;;';;;;;'';;'''';;;''''''''
#;;;:;';;;;';''''';;:;;;;;;;;;:::;:;;;,:;::;;';:;;::::;;;;;;;;;'''''''';+':;;'++:';+;::,,,,.+....;.;,,''+:';;'';';;'+;;;::;;''';;;;:;:;;;;;;;;;;;;;;:;;:;;:;;:;;;;;;;::;;;;;';;;;;;;';'';'';;;;;''''''''
#';''';';'';;'';'';;;;;;;;;;;;;;::;;;;:;;;;:;;;;;::::;;'+';::;''''''''':+;;;':;''+:'#::,,,,,++,,.'':::'';@''''';;';+';;:;';';':;;;::::;;;;;;;;;:;;;;;:;;;;;';;;;;;';;;;;;;;;;;;;;;;;'';;;'';;;''''''''''
###;;;;;;''';''';;';:;;;;;;;;;;;;::;;::';:;;:;;;::::;;;';;;;;;;'';;'''';+;::;';;+;'';#;,,.,,+,,,,'+,::';+''+'+';;;'+;:;';;;;:';;;;;::::;;;;;;';;;;;;;;::;;;;;;;;;;;;;;;;;;;';;:;;;';';;'''';';''''''''''
#''';;;';;''';;'';;;;;;;;;;::;:;;;;;:;;:;;;;';:;::::;''+';;:;;;;;;''''';+++:;+;:+:;++;:::,,,++#,,+:#::'';++++';;;'+;:;''''';;;;;:;::;;;:::;;;::;;;;;;;;;;;;;;;;:';;;;;;;;;;';;;;;'';;''''';;''''''''''''
+'''''''''';''''';'';:;;;;;;:;;;;;;;;;::;:;;;;:;;;;;'+';;;';'#.'';;''';';;;:;'';;;';+'',,.,,.,::;'''++''''++++'';+';;';;;;;;;:;;;;;:;;:;;;;;;;;:;;;;;;;;:;;;::;;;;;;;;;;;';;;;;;;;';;;;;'';;''''''''''''
#''''''''''''';;';;;;;;;;;;;;;;;;;;';;;;;::;;:;:;;:'+''';';';;''';;;';'';;::;;'''''::'::,.,.,,''++;;::+++++;;;+;+++:'''';;'';;'::;;;:;;;;;;;;;;;;;;;;:;::;;;:;;;;;;;;;;;;;;;;:;;;;;;;;;;;'''';'';+;'''''
+''''''''''';'';;'';;:;;;;;;;;;;;;:;;;;;:;;+::;:;;;;';:;;;;';;+';;';;++,;;;;;';''';;''':::::+;+';;::';;:'';;;#;:;'+:'''':;:;';;;;;;;;;;;;;;;;;;;;;;;;;;;;;;;:;;:;;;;;;;;;;;;;;;;;;;;;;;';'';';;';'''''''
#''+++++'+'''''''';;;;';';;:;;;;;:::;;;:::;;;'::;'';';;;'''`;+'';;;;'',#;;;;';'''''''+;;:::;'++;;;+,,,;;+;';;''+;'+:+:;'::';:;;;;;;;;;;;;';;;;';;;::;;::;;::;;;;:;;;;;;;;;;;;;;;;;;;;;;;;'''';';''';;'''
#+++'++'''''+;';'''':;';;;;;;;;;;;::::::::;::::;;:;';;;;;;':+#'';';:#,''';;'+;;;;;;;'+';';';'';:+;;,,,+';;:':##;;++;;''::;;+::;;;;;;;;;;;;'';;;;;;::;;;:;;;;:;:;;;;;;;;;;';;;;;;;;;;;;';;'''';'';'';;'''
#++++++'+''+''+''';;;;;;;';;;;;;;;;;:;;:;:::::;:;;;';;';;;;;';;''''+,;++';;+''''';;:'';'''';''+;':#,,+';;;:':+;;:+'':++;;;;:';;;;;';;;;;;';;;;;;;:;:;;;:;;;:::;;:;;;;;;;;;;;'';;;;';;';;;;;;';'';;';''''
#+++++'+''''''''''';;;'';';;;:;;;;;;;:;:;;;::::;;;:+;;;;;;;;';;+;''+##+;;'''''''''';';+;;;;;';:#+''',#:,;:+;;;+:+;;+:;;:';':';;;;;;;;;;:;;;;';;;;;::;;:::::::;;;:;;;;;;;;;;;;;;;;;;;';;;;;;;'''''';;';''
##+'+++''''''''''''';;;;;;;;;;;;;;;;:::;;::::;;;:';'';;+++;';'+';;;;';;;';;;''';;';;:'::;:;:';+;:;':;'+;:'+';;;;;;':;';;;';:;;;;;;;'''':;;';;;;;;;:::;:;:;::;;;;;;:;;;;;;;;';;;;;;;;;;;;;;;;'';;';;';:''
###++++'+'+'''''+'';;;;;:;;;;;:;;;;;:::::;::;;;:::;;''';;''';;;'';;;;::;;;:'';''''';;''+'';;+';;;;::;::::;;'';';++';;';;''';:;;;;;;;;;;;;;';;;;;;:;:::;;:;:;;;;;;;:;;;;;;;;;';;;;;;';;;;;;;';';';;;';;''
##++''#+';;''''';'';;:;;;;++;;;:;;;;;;;;;'';;;;;::;;;;;:;;'''''';+''';;;';';';;';';;+'''''++''';:;;+;::::;;;''+'+;:;';:::;:;:;;;;;;';;::;:;;;;;;;:;::;;;;;;:;;;;;;;;;;;;;;;:;;;:;;;';;';;;'';';;+;;;;;''
+#++''+''+++;'''';'';;;;;';'';;;;;;;;;;;;;'';:;:;::;;;;;;;;;;;:;;;;;''';';';;'';;;'++;;;;;''+'';;:;+;':::;;'';;;;;'';;;;:::;;;:;;;;;;';;;;;';;;;;:::;;;;:;;:;;;;;:;;;;;;;;;:;;;:;;'';;'';+';';'';;''''''
+#++'+'+''''';';';'';';;;''';';;;;;;;;;'+;;;;;::::;::;;;;;;;:;::;:;;''';;;;;';';;'';'+::::;;'+;;;;;:'::::;;;':;::'''';'''''';;';:;;;;;;;:;';:;:;:;::::;;:;;:;;::;;:;;;;;;;;;:;;;;;;+;;'';;:'+;';;;;''';'
#++''++;'''';''';;;''';;;;;;;;+';;;''''';;;;;:;:;:::::::;;;;;;;;;;;;'';';:;;:;;;;;;;;+;;::;;;;+''';;:::;;;;;+;;'';';''''';'';';;;;;;;;;;:;;;;;;::;;;::;;:;::;;;;;;:;;;;;;;;;;;;:;'';;'';:'+;';;;;;;;;'''
#''''+';'''';;;;;;'''';;';;;''';;;;;;;;;'';:;;;::::;:::;;;;;;;;;;;;;;;;;;:;;;':;;;;;;+';+;;;;;+;';;'';:;::;'+;;;';;;';;;;;::;;;:::;;;::;;;:;;;::;;;:::::::::;:;;;;;;;;;;;;;;;;;;;'':'':;';'''++';;;;;;;;
#++';'++'+';''';;;;;';+'':;'';''';';';'';'';';;;:::;::::;;:;;::;:;::::;::;;;;;;;;''''+#;#;;;;;;';+'''+';';+''+:;''';;;;;;:;::;;;;;;;;:'::::;;;::;::;:;::;;;;:;;;;;;;;;;;;;;;::;:;''';'+'';'';;;;':;;'';;
+'''';+#'+';;;'';;';;;';';';;''';:;;;;';;';;';;;;::::;:::;;;;;:;;;:;;;:;;;;;;;;;'''';;';+:;;;;';;'+';;';:;;;;'+;;;;;;'';;';;;;';;:;;;;;:;:;:::;:;;;:::;::;:;::;;;;;;;;;;;;;;;;:;;''';;:'::';;;';;;:;;;;'
#'';'''+;;';+'+';;;;;'';:;;;'';;;:::;;;;;';;;';';:;;::;;;:;;;;;:;:;:::;;::;:;;;;;;;;;'';::;;;;;;;;'+;':;;;;;;;':;;';;';;:;;:;;;;;:;;:;;::';;;;;::;;;::::;;:::;;;;;;;;;;;;;;;:;;'++;;';:;:'::'+''''''''';
#''''+'';';';;'';'';;;';:';';;;;;;::;;;;'';'';':;:::::;:;::;;;;:;:;::;;::;:;;;''''''+;+;;;;;;;;;';;+':#;::;;;'';;;;;;;;;;:;;;:::;;;::;;;;;:;:;:::::::;:::;:;;;;;;;:;;;;;;;;;;:;';';':;++;'::;''';;';;;;;
#'''''+;;;;'+':;:;'';:;;;;';';;;;;;;;;;;;;;''';::';;::;:;::;;::;::;:;::::;;;;;;;;;;;;;+';;;;;;;;;''+;+':;:;:;'+;;''';;'';;;:;;:;;;;;;;:;;;:;:;;::;:::::::;:::::;;;;:;;;;;;;;;;';:+,;+;;'';:::';;;'';';;;
+'';;;''';''+';;;:;';'''';'''';;:;;;::;;:;;;';;;::;;::;::::;;:::::;;;;::;:;''''''';;';+'''';;';;'''+';;:;;;;'#;:;';;;;;;;;;;::::;;;:;:;:::;:::;::::::::::;:;:;;;:;;;;;';;;;;;;':::';''::':;;::';;;;;;;;;
+'';;;''';''+'+''''';;'''''''';;:;;;;:;;;;;;;;;'::';;;;::::;::::::;;;;::::;;;'';';;+++++'''''''''''+'';:;;:;;''';;;;;;;;;;;::;::;;:;:::::;;;:;:;:;:::::::;::::;;:;;;;;;;;;;;:;';''+;';';:::';;';;::;:;;;
+#';;'''+'++++''';::::;';;'''';;;;;;;;;;;;;;;;;+;:;;;;;::::::::::;;::::::;;;;'''';+'''+'+++++''++++++''''';;+;;++;';;;;;;;;;;::::::::;;:::::::;;::;::::::;::;;;;;;:;;;;;;:;;;;';+':;'';:::::';:;::;;;;:'
+#';;;''+'+'++';:;;:;;;;'''''';;;;;;;;;;;;;;;'::;:;;;;;;:::::::::::;;;::;;;;'''';+;;:;''+'++++'+++++'+';;;;;;;;'+:'';;;;;;::::::::;::::::;;:;;;;:::::::::::;:;;:;;;;;;;;;;;;;;'';'+;'::';;;:''::;':;;;:;
+#''';''+''+++'';;;:;;:;;;;'';;;;;;;;;;;;;;::;::';';;:;::::::::,:::;;:::;;:;;:;;;+'::';'+''''';;;;'+;''';;;;;;;'+;;';;;;;;:::;:::::::;;;:;:;:;;:;:::;;::;;:;:;;:;;;;;;:;:;;;;;;;';'';';;'':;;';;;;';;;:'
#''''''++++++';';;;;;;;;'''''';';;;;;;;;;;;;;'';;+;;;;';::;::;:::::;;;;:;:';';'';';:::#++''';;;;'';''''+;;;:;;;'+:';;;;:;;;::::::::::::::;;:::;;:;::::::::::;;;:;;;;;;;;;;;;;:;;;'';;:;''+';;;;';';';;;'
#'''''+++';'+;;;;;;;;;;;+;'''';;''';;;;;;;;:;''+:;;;;;;:;;;;::::::::::;;:;';'''';';::'+'+'';:;::+;;;'''':+'+;;;'+;;';;;;:;::::::,;;':;::::;::;;;;::::::::;:;;:;;;;;;;';;;:;;;:';';;+';';''+;;:'';;';;;'+
#+''''++++;;';;;;'''';;;;'+'''';;;';;;;;;;;;;'''';:;;;;;;;:;;:;::::;:::;;:;;;;;''';:;,;+++';:::,::';'''+++;+;+'';';';;;;::;::::;:;,::;;:;:::;:;:;;;::;:;:;:;;;;;;;;;;;;;;:;;;:'';'';''+';''';;;;;''';''#
+'+''''''+'''';'';;;;;::,:+'''''''';;;;;::;;';';';;:;;';;;;;;;:;:::;;:;;;;;;;''''+;::;;'++';:;:;:;;;'''+;;;++#++;';;;;;;;:;:;:::,::;;::;;;::::;;:;:::::::;;:;;';;;;;;;;;;;;;;;;'';;;';;;;''';;;'''';;''#
+'''''''''#+'+#'';:;;:::;::''''+;;';;;;;;;:;';;;;';;;;;;;;;;;;;;::::;:;;::;;;''';'';;;;''++;;:;::;;;';;';;;+#'';;';;;;;;;::;;;:::,;:;;:::':::::;;:::::;;;;;;;;';';;;;;;;;:;;;:;;'';''+;'';''';;;'';;;:+#
#'''''+'''++'#'';;;;;;::::;+';';';;;;:;;;;;;;;;;;'';;;;;;;;::;;::::::;;;;:;;;;';;;+'+'''++++'+';'''';';';:;;;'';'';';;;;;;;::::;:::;'';''::::;;;;:::::;;;;;:;;;;;;;;;;;;;;;;;:';;;:;'';;';;''';;'';'',+#
+''''+'''+''''#''';;;;;;;;;'';;;;;';;;;;;;;;;;;;;;;;;;:;;;;::;;;::::;;;;;;:::;;;;;+;+;++''+''';;;;'';;';;:::;'+'';;;;;;;;::;;:::';::;;';;::::;;;;:::::::;;;;;;;;;;;;;;;;;'';+;';;;''';';'';'';;';;'.+,;#
#''''+''''++;'+''+''';''++;;';';;;';;;;:;;;;;;;;;';;;;;;;;;::;;::::;::;:;;:;;;;;;;;++;''''''++;;;;;;;;;;;:::;'+;'''';;;;;;:::::;;:;:;''::':;';::::;:::::;;;;;';;;;;;;;;;;+';;;+'';;'';;;'';;'';';',;;:'+
#'''++''''++'+''''+';;;;''''+;''';;;;;;;';;;;;'';:;;;;;;;;;;;;;;:::::;;;;;;;;;';'''';';++'''';';;;;;;+;;::::;'';:;;;;;;;;;;;::;;::;;;';'';:;':::::::::::;;;;:;;';;:;;;;;;+;'';+';;;''''''+';;';'':';#:''
+'''+''''+++''''+';;';'''+'+:''';;';;:;;;'';'''';;:;;;;;;;;:;:;;;:::;;;;;;;;;;;;;''';'''':;'+'+:;;;;;+;;;;;;;'+;:'::;;;;;;:;;;;;;;;;;';;;;;:';;;;::::::;;;;';;;;;;;;;;;;'''':;';';;;+;;;';';'''+;','++++
#''++'+'++#+'''''''''';'++'+'';;';';;;;;;;;';;';;+;;;;;;;;;;:;;;:::::;;:;:;:;;;;;;;;;;''';'+++;;;;;;;+;;;;;;''';';;;;;;;;:;;;;;;;:;:;;;;'''';;;;;;;:::::;;;;;;;;;;;;;;;;+;;::;';;;''';';';''+'+++'+:++::
#'+''++++#++++'''''';;;'+'';;+;'''';;';;';;''';;;::;';::;;:;:;;;;::::;:;::;:::;;;;;;:;;;;#;+'+;;;;;;;''';;'''+':;;;;;;;;;::;:::;;;;;;;;;;;;;:;:::::;::;:;;;;:;;;;;;;;;';;;;;'+';;;'';:;;;;;''+'';;;':'++
#'+'+'+++++'+'''';;++'''';';:'';'''';;;;;;'''''';':;';;::;:;;;;;;::;;;;;;:::;;;;;;';''''':;;+;+;;;;;;;+';'+++':;;:;;;;;;;;;;;;;;;:;;:;;;;;;;;;;;;;;::;:;;;;;;;;;;;;;;;;;;;;;;:'';;';;;;';;;;;;'';::+';;+
#'+++++++++'''+''';+'+''';';:;''''';;;;';;+'+;''';;;';;:;;;;;;::;:;::;;:;::;;;;;;;;;;;;';++;++';;;;';;'++';:::;';;;;;:;;;;;:;:;;;;;;;;;;;:;::;:;;;;:;;;;;;;;;;;;;;;;;;;';';;;;';;;;'';;;';::;'''',';'+':
+''++++++''++++';';++'''';+'''''''''';'''''+';;::;;;;';;::;;;;;;;:;:;;;;;;;:;;;;;;;'''';;+'+##;;;;';''+';;'''';;;:;;;;;;;;;:;;;:;;;;;;;;;;;;;;:;;;;;;;;:;;;';;;';;;;';';';;;;;'';'';';;';;;:;;';:';+++++
++++'+'++++'++#;'';''''';;;;'';;''''''''';+';''';;;;';;;;';;;;;:::::;;:;;;;:;;;;;;;;;;';'+'';'';;;''+':;';;;;::;;;;;;;;;;;;;:;:;;;;;;:;;;;;;;:;:;;;;;;;::;;';;;;;;;;;:'+;;;;;;;;:;';''';';;;;;,,''+'##'+
+'+++++'+++'+'+'';+;'';';;+;'''''''''''+''';;;;';;;:;;;:;;:;;;;:::;;;;;;;;;;;;;;;;;;;;'+++''''++''+'::'';;;;;;;::;;;;';;;;;;;;;;;:;;;;:;;;;;::;::;;;;;;;;;;;;;;;;;;;;;:';;';;;;+;;';'''+';;;;;:;:'+##+''
++++++#++++'++';;''''+'';';'''';;'++'+'+'';;;;';''';';:;;;;;;;:::;;:;;;;;;;;;;;;;;;;;;';'+''++;;'';;;';;;::;;:;;:;;;;'';;;;;;;;;;;;;;;;;;;;;;:;;;:;;;;;;;';;;;;;;';;;;;;;;;;;';'''+'''++'';';,'::'###'+;
#'+++++'+++'+''++''+'+'';''''';++';''''+''';;;;;';;'';;:::;;;;:;;;;;;;;;;;;;;;;;;;;;''+'++'+'+'';;'';;;;:;;:::;;;;;;;'';;;;;;;;;;;;;;;;;;;;;:;;;;;;;;;;;;';;;;;;;';;;;;';;;;;';';;;;;;''''',;+'':##++,''
#''++++'+++++''''''''++'''''';;'';''++''+';;;;;;+;''';;;:;:;;;;:;;;;;;;;;;;;;;;;;;;;''''+''+'';;;;;;;;;;;;;;;;;;;;;;;''';;;;;';;';;;;;;;;;;;;;;;;;;;;;;;;;';;';;;;;'';'';';;';;;;;;';;',;''',+''+;:+;;'#
+++++++++'+'++++'''''+'''';'''''';;''++;++;'+';;+';';;::::;;:;;;;;;;;;;;'';;:;;;;;;;;;+;;'++'';;;;;;;;;;;;:;;:;;;;;;;;'';;;;';;;'';;;;;;;;;;;;;;;;;;;;;;;;;';;;;;;;';';;;;;:;;;;;;;;;;:;';''':'+#';:;+#+
+++++++++++;;++++''''++''';'''';'';'''+'''''';;'''';;;::;:;;;;;;;;;;;;';;;';;;;;;;;;;;''+#+;:;;;;;;:;:;;:;;;;;;;;;;;;;';;;;''';;;::;;;;;;;;;;;';;;;;;';;;;;;;;;;;;'''';;;;';;;;;':;;;:';+''+;'+#++:'+#+'
++++#++++';;''++''''''''';';''''';'''+++''''''''''';;:::::;;;;;;;;;;;;';;;';;;;;;;;;;''';#+;++;;;;;;;;;;;;;;;;;;;;;';;'';''';';;':;;;;';;;;;;;';;'''';'';;;;;;;;+'';;'';';'';;';';;;;'''++''+++#';:++::#
##++++'+;;';'+'''+'+'''''''''''''';;''''';;''''''';;;;::::;;;';;;'';';'';';;;;';;;;;;''+'+;;++';;;;::::;;;;;;;;;;;;'';''';'''';'+::;;;;;;;;;;'';''';''''';;;;;;;'''';''''';';;';;;;;:;',:'+''+++'''#':+#
###+++'+'''''''''++''+''''''''''''';''+''''''''''';;;:':;;;;;';;;''''';';;';;;;;';;;;;;;;'';+''';;;;;;;;;;;;;;;';;;;;;;;;''';':#':::;;';'';;;;;';''''''';;:;;;;'';;';'''+';;''';:''';'+';;'+''';,'+#'+;;
######++++'''+'+++++++++'''''''''''''''''''''''';';;;';:::;;;';;'''''''';';;;;;;';':;';'''''''+;;:;:;;;;;;;;''''';;;;;''''';;'+#;;:::;'''''''''';'''''''';;;;;;'';;''';;';';;';';'+#'+#;'''++''';;#'##+;
########+++++++++++++++'''''''''''''''''''';'''';';;;+;::;;;;';'''''''';'';;;;;;;;;;;';;';;;;;#;;;;;;;;;;;;;;''';;;;'''''''';+++;;;;;;;;;''''''''''''''';;;;;;'''+'+''';;;';''''+++'''+;'+++'''''+#'+##+
##############++++++++++''''''''''++'''''''';;'';;';'+;;;;;;;''''''';''''''+'''#;''';'''';;;;;#+;;:::;;;;;;;;''''';;+;''+''';+#+;:;;';;';;'''''''''''''';+;;;;';''''';''';;;''+#+'+;''#''+#++#+;'+#+++##
